000000000000000
022222022222210
020002020000220
022202223220220
000200000020020
022222222022220
020000002000020
022223202223220
020000200000020
000000000000000