000000000000000000000000000000000000000000000000
042222200000000000222222222000000000000000000000
022222232222222220222222222000000000000000000000
020000002000000020200000002000000000000000000000
023333302055555020233333302000000000000000000000
020000002020002020200000002000000000000000000000
022222222020002022222222222222222222222222220000
000000002020002000000000000000000000000002220000
022222222020222222222222222222222222222002220000
022000000020200000000000000000000002222002220000
022033333320205555555555555555555502222002220000
022020000020200000000000000000000002222002220000
022020222220222222222222222222222222222002220000
022020222220000000000000000000000000000002220000
022020222222222222222222222222222222222222220000
022020000000000000000000000000000000000000020000
022222222222222222222222222222222222222220020000
020000000000000000000000000000000000000220020000
023333333333333333333333333333333333330220020000
020000000000000000000000000000000000000220020000
022222222222222222222222222222222222222220020000
000000000000000000000000000000000000000020020000
022222222222222222222222222222222222222220020000
022222222222222222222222222222222222222221020000
000000000000000000000000000000000000000000000000