000000000000000
022222022222210
020002020000220
022205223220220
000200000020020
022223222022220
020000002000020
022222202222220
040000200000020
000000000000000