000000000000000000000000000000
042222200000000000000000000000
020002222222222220000000000000
020002000000000022000000000000
022222022222222022222522200000
000002020000002020000000200000
000002022222202020222220200000
000002000000202020205020200000
000002225220202020223220200000
000000000020202020200020200000
000002222220202222200020200000
000002000000202000000020200000
000002022222222022222220200000
000002020000000020000000200000
000002020222222220222222200000
000002020200000000200000000000
000002020205222222223222210000
000002020200200000000000000000
000005022222222222222222200000
000000000000000000000000000000