000000000000000000000000000000
022222200000000002222222222000
022222200000000002322222222000
022002322000000002322000022000
022002222220000002232000022000
022000022520000000022000022000
022000022222522000022000022220
022220000000022000025000022220
022222225252252252222000000220
042222222222222222222000000210
022220000002200000022000000220
022220000002200000022000000220
000220022222200000022000000220
000220022220000000022002222220
000222222000000002222002222000
000002200000000002222002200000
000002222222222222222222200000
000002222222222222222222200000
000000000000000000000000000000